Map:
------------
------------
------------
------------
------------
------------
----#%#%----
----#%#%----
---#%#%#%---
---#%#%#%---
&&#%#%#%#%--
&&#%#%#%#%--
&&#%#%#%#%--
&&#%#%#%#%--
---#%#%#%---
---#%#%#%---
----#%#%----
----#%#%----
------------
------------
------------
------------
------------
------------
Map/

Meta:
Name: Central Mass
Unbreakable: &
PowerUp: %
Time: 200
Meta/

Legend:
#) red-block.png
%) orange-block.png
&) grey-block.png
Legend/